Timestamp; Remesa; Mensajes generado en remesa; Cola Longitud; SiguienteRemesa; Total Producidos
18;1;700;700;65;700
96;2;375;375;87;1075
190;3;511;511;10;1586
206;4;830;1341;40;2416
253;5;786;2127;58;3202
316;6;836;2163;81;4038
409;7;679;2042;54;4717
472;8;442;2484;21;5159
502;9;961;2645;96;6120
600;10;817;2662;48;6937
657;11;601;3263;35;7538
703;12;859;4122;12;8397
717;13;416;3738;48;8813
779;14;415;4153;86;9228
873;15;704;4057;44;9932
919;16;905;4962;6;10837
935;17;726;4888;25;11563
966;18;599;5487;87;12162
1061;19;778;5465;66;12940
1139;20;681;6146;15;13621
1169;21;888;6234;67;14509
1246;22;841;7075;100;15350
1355;23;981;7256;84;16331
1449;24;542;6998;26;16873
1480;25;819;7017;20;17692
1510;26;575;7592;90;18267
1605;27;964;7756;49;19231
1666;28;379;8135;14;19610
1681;29;344;8479;48;19954
1742;30;360;8039;43;20314
1788;31;858;8897;25;21172
1819;32;737;8834;5;21909
1834;33;563;9397;2;22472
1836;34;331;9728;53;22803
1897;35;444;10172;59;23247
1959;36;528;9900;2;23775
1962;37;313;10213;52;24088
2022;38;307;9720;96;24395
2130;39;418;9338;16;24813
2161;40;956;10294;81;25769
2255;41;717;10211;95;26486
2363;42;609;10020;39;27095
2411;43;476;10496;31;27571
2442;44;946;11442;15;28517
2458;45;956;11598;38;29473
2504;46;661;12259;5;30134
2520;47;977;13236;41;31111
2568;48;812;13248;3;31923
2583;49;951;14199;93;32874
2692;50;840;14239;44;33714
2739;51;396;14635;26;34110
2770;52;990;15625;95;35100
2880;53;641;15466;56;35741
2942;54;648;15314;40;36389
2988;55;758;16072;74;37147
3065;56;853;16125;64;38000
3144;57;388;15713;96;38388
3254;58;648;15561;78;39036
3346;59;967;15728;25;40003
3378;60;637;16365;96;40640
3489;61;497;16062;29;41137
3521;62;641;16703;61;41778
3584;63;535;16438;42;42313
3632;64;721;17159;52;43034
3692;65;927;17286;69;43961
3769;66;524;17010;43;44485
3815;67;483;17493;22;44968
3847;68;938;18431;32;45906
3892;69;569;18200;38;46475
3939;70;583;18783;92;47058
4046;71;520;18503;16;47578
4078;72;463;18966;42;48041
4126;73;855;19021;46;48896
4188;74;755;19776;27;49651
4219;75;916;19892;17;50567
4251;76;823;20715;20;51390
4282;77;892;21607;97;52282
4392;78;690;21497;85;52972
4482;79;548;21245;67;53520
4562;80;952;21397;16;54472
4592;81;709;22106;20;55181
4624;82;905;23011;82;56086
4716;83;422;22633;14;56508
4732;84;840;23473;64;57348
4811;85;375;23048;61;57723
4888;86;858;23106;99;58581
4996;87;320;22626;89;58901
5090;88;395;22221;74;59296
5167;89;348;22569;75;59644
5244;90;456;22225;89;60100
5339;91;791;22216;99;60891
5449;92;833;22249;98;61724
5557;93;991;22440;50;62715
5607;94;746;22386;78;63461
5698;95;623;23009;61;64084
5759;96;399;22608;83;64483
5851;97;396;22204;4;64879
5866;98;347;22551;62;65226
5928;99;322;22073;48;65548
5988;100;560;22633;38;66108
6035;101;465;23098;32;66573
6083;102;797;23095;20;67370
6114;103;996;24091;9;68366
6129;104;457;24548;19;68823
6160;105;512;24260;87;69335
6252;106;908;25168;66;70243
6332;107;339;24707;86;70582
6426;108;374;24281;53;70956
6487;109;748;24229;24;71704
6517;110;619;24848;34;72323
6564;111;623;25471;92;72946
6657;112;483;25154;14;73429
6672;113;523;25677;5;73952
6688;114;370;26047;41;74322
6734;115;390;25637;38;74712
6783;116;369;26006;30;75081
6828;117;526;25732;78;75607
6908;118;899;25831;39;76506
6951;119;681;26512;79;77187
7046;120;939;26651;46;78126
7093;121;398;27049;33;78524
7127;122;453;26702;82;78977
7217;123;851;27553;34;79828
7263;124;633;27386;33;80461
7311;125;721;28107;34;81182
7356;126;533;27840;85;81715
7452;127;689;28529;89;82404
7545;128;410;28139;9;82814
7560;129;877;29016;57;83691
7623;130;360;28576;20;84051
7653;131;461;29037;94;84512
7747;132;573;28810;76;85085
7826;133;531;28541;45;85616
7873;134;990;29531;75;86606
7950;135;654;29385;97;87260
8060;136;988;29573;82;88248
8152;137;652;29425;70;88900
8230;138;482;29107;51;89382
8292;139;783;29890;38;90165
8337;140;544;29634;33;90709
8383;141;357;29991;92;91066
8476;142;698;29889;69;91764
8554;143;514;29603;13;92278
8569;144;762;30365;99;93040
8677;145;948;30513;31;93988
8709;146;444;30957;67;94432
8787;147;422;30579;27;94854
8819;148;453;31032;37;95307
8867;149;371;31403;37;95678
8912;150;407;31010;96;96085
9023;151;563;30773;77;96648
9101;152;553;30526;75;97201
9178;153;415;30941;92;97616
9271;154;780;30921;74;98396
9349;155;889;31010;71;99285
9427;156;571;30781;83;99856
9520;157;546;31327;44;100402
9568;158;633;31160;55;101035
9630;159;779;31939;59;101814
9693;160;654;31793;51;102468
9753;161;692;31685;21;103160
9784;162;456;32141;65;103616
9849;163;546;31887;72;104162
9922;164;581;32468;44;104743
9969;165;759;32427;73;105502
10045;166;701;33128;68;106203
10124;167;490;32818;50;106693
10174;168;776;32794;6;107469
10186;169;724;33518;7;108193
10202;170;695;34213;59;108888
10262;171;588;34801;28;109476
10293;172;862;34863;78;110338
10386;173;706;35569;50;111044
10449;174;850;35619;62;111894
10526;175;570;35389;49;112464
10588;176;505;35894;24;112969
10620;177;889;35983;73;113858
10698;178;483;36466;15;114341
10713;179;728;37194;44;115069
10761;180;424;36818;66;115493
10837;181;785;36803;49;116278
10900;182;847;37650;63;117125
10978;183;365;37215;8;117490
10993;184;335;37550;72;117825
11070;185;593;37343;75;118418
11148;186;768;38111;66;119186
11223;187;565;37876;89;119751
11316;188;938;38014;28;120689
11347;189;729;38743;80;121418
11439;190;573;38516;0;121991
11440;191;571;39087;90;122562
11531;192;899;39186;76;123461
11608;193;363;38749;18;123824
11640;194;782;39531;53;124606
11703;195;768;39499;26;125374
11734;196;973;40472;77;126347
11812;197;488;40160;89;126835
11909;198;773;40933;66;127608
11988;199;524;40657;59;128132
12049;200;576;40433;93;128708
12158;201;995;40628;54;129703
12221;202;660;41288;96;130363
12332;203;566;41054;49;130929
12396;204;601;40855;67;131530
12476;205;332;40387;1;131862
12477;206;488;40875;18;132350
12507;207;678;41553;64;133028
12583;208;895;41648;33;133923
12631;209;699;42347;49;134622
12680;210;426;41973;20;135048
12708;211;629;42602;28;135677
12739;212;599;43201;5;136276
12755;213;405;43606;95;136681
12865;214;399;43205;9;137080
12881;215;580;43785;89;137660
12975;216;398;43383;86;138058
13068;217;804;43387;16;138862
13097;218;508;43895;36;139370
13146;219;582;43677;35;139952
13193;220;458;44135;87;140410
13285;221;462;43797;69;140872
13364;222;957;43954;99;141829
13473;223;381;43535;25;142210
13504;224;845;44380;6;143055
13520;225;624;45004;4;143679
13523;226;773;45777;96;144452
13627;227;658;45635;15;145110
13643;228;926;46561;70;146036
13722;229;559;46320;42;146595
13768;230;717;47037;47;147312
13815;231;400;46637;55;147712
13877;232;822;47459;49;148534
13940;233;638;47297;17;149172
13970;234;760;48057;58;149932
14031;235;939;48196;58;150871
14092;236;375;48571;64;151246
14171;237;703;48474;38;151949
14218;238;833;48507;18;152782
14249;239;793;49300;67;153575
14316;240;586;49086;26;154161
14358;241;590;49676;86;154751
14451;242;642;49518;42;155393
14498;243;472;49990;40;155865
14545;244;445;49635;78;156310
14625;245;788;50423;71;157098
14703;246;772;50395;71;157870
14781;247;606;50201;67;158476
14859;248;532;50733;69;159008
14939;249;712;50645;93;159720
15046;250;814;50659;71;160534
15123;251;810;50669;92;161344
15217;252;308;50177;57;161652
15279;253;995;51172;68;162647
15356;254;866;51238;44;163513
15401;255;488;51726;87;164001
15494;256;769;51695;35;164770
15539;257;674;51569;85;165444
15632;258;900;51669;97;166344
15741;259;477;51346;55;166821
15803;260;719;52065;24;167540
15834;261;377;52442;12;167917
15849;262;708;52350;60;168625
15911;263;525;52875;34;169150
15957;264;382;52457;57;169532
16021;265;335;52792;8;169867
16036;266;468;53260;24;170335
16067;267;695;53155;5;171030
16082;268;705;53860;34;171735
16129;269;575;54435;32;172310
16163;270;687;54322;66;172997
16237;271;939;55261;31;173936
16271;272;996;55457;11;174932
16284;273;331;55788;2;175263
16300;274;474;56262;18;175737
16332;275;307;56569;88;176044
16426;276;892;56661;41;176936
16473;277;602;57263;91;177538
16568;278;987;57450;46;178525
16615;279;974;57624;38;179499
16663;280;343;57967;40;179842
16709;281;563;58530;89;180405
16803;282;585;58315;74;180990
16879;283;885;58400;77;181875
16971;284;474;58074;93;182349
17080;285;747;58021;25;183096
17112;286;387;58408;40;183483
17159;287;415;58023;74;183898
17237;288;591;58614;42;184489
17284;289;661;58475;78;185150
17363;290;458;58933;44;185608
17410;291;939;59072;49;186547
17472;292;389;59461;39;186936
17518;293;927;59588;63;187863
17583;294;836;59624;38;188699
17627;295;316;59940;68;189015
17705;296;511;59651;12;189526
17719;297;461;60112;16;189987
17735;298;662;60774;4;190649
17751;299;940;61714;61;191589
17813;300;472;61386;20;192061
17843;301;609;61995;57;192670
17906;302;470;62465;62;193140
17970;303;736;62401;32;193876
18009;304;548;62149;40;194424
18064;305;475;62624;75;194899
18141;306;423;62247;26;195322
18173;307;513;62760;15;195835
18204;308;786;63546;94;196621
18298;309;799;63545;69;197420
18376;310;717;63462;46;198137
18423;311;762;64224;35;198899
18469;312;463;63887;1;199362
18470;313;707;64594;89;200069
18562;314;396;64190;74;200465
18639;315;597;64787;43;201062
18686;316;700;64687;1;201762
18688;317;583;65270;56;202345
18750;318;526;65796;54;202871
18814;319;783;65779;13;203654
18830;320;926;66705;13;204580
18845;321;611;67316;0;205191
18846;322;799;68115;73;205990
18923;323;921;68236;92;206911
19017;324;548;67984;53;207459
19079;325;516;68500;86;207975
19174;326;801;68501;47;208776
19236;327;998;68699;23;209774
19267;328;330;69029;9;210104
19283;329;670;69699;73;210774
19360;330;681;69580;67;211455
19439;331;605;69385;72;212060
19518;332;644;70029;94;212704
19613;333;923;70152;97;213627
19724;334;424;69776;5;214051
19740;335;992;70768;81;215043
19836;336;747;70715;39;215790
19882;337;382;70297;55;216172
19944;338;523;70820;53;216695
20007;339;926;70946;77;217621
20086;340;915;71861;73;218536
20163;341;652;71713;15;219188
20179;342;776;72489;58;219964
20243;343;858;72547;55;220822
20306;344;561;73108;24;221383
20337;345;783;73091;21;222166
20369;346;966;74057;20;223132
20399;347;488;74545;55;223620
20462;348;491;74236;25;224111
20494;349;755;74991;7;224866
20510;350;450;75441;49;225316
20572;351;606;75247;62;225922
20635;352;565;75812;65;226487
20710;353;865;75877;0;227352
20712;354;628;76505;38;227980
20758;355;919;76624;70;228899
20833;356;791;77415;25;229690
20865;357;375;76990;34;230065
20911;358;828;77818;41;230893
20960;359;822;78640;71;231715
21036;360;820;78660;52;232535
21097;361;849;78709;76;233384
21176;362;527;79236;27;233911
21206;363;745;79181;92;234656
21301;364;616;78997;62;235272
21365;365;615;79612;29;235887
21396;366;488;80100;90;236375
21491;367;448;79748;60;236823
21553;368;924;79872;48;237747
21615;369;742;80614;59;238489
21677;370;890;80704;21;239379
21708;371;311;81015;57;239690
21772;372;383;80598;89;240073
21862;373;317;80115;60;240390
21923;374;621;80736;56;241011
21987;375;928;80864;0;241939
21989;376;688;81552;85;242627
22081;377;975;81727;38;243602
22126;378;591;82318;84;244193
22222;379;968;82486;81;245161
22312;380;346;82032;37;245507
22359;381;860;82892;54;246367
22422;382;823;82915;90;247190
22514;383;460;82575;98;247650
22622;384;891;82666;26;248541
22654;385;558;83224;99;249099
22764;386;663;83087;74;249762
22842;387;462;82749;9;250224
22857;388;997;83746;72;251221
22935;389;992;83938;58;252213
22996;390;356;84294;10;252569
23013;391;781;85075;71;253350
23090;392;761;85036;62;254111
23168;393;364;84600;99;254475
23276;394;334;84134;45;254809
23324;395;653;84787;33;255462
23357;396;416;84403;9;255878
23371;397;412;84815;55;256290
23435;398;813;85628;45;257103
23482;399;628;85456;66;257731
23561;400;306;85762;9;258037
23576;401;529;86291;38;258566
23624;402;598;86089;91;259164
23717;403;503;85792;71;259667
23797;404;368;86160;86;260035
23891;405;384;85744;78;260419
23984;406;374;85318;31;260793
24015;407;747;86065;15;261540
24031;408;530;85795;98;262070
24141;409;519;85514;16;262589
24157;410;637;86151;35;263226
24206;411;662;86813;49;263888
24267;412;714;86727;19;264602
24298;413;594;87321;19;265196
24328;414;484;87805;80;265680
24424;415;968;87973;82;266648
24520;416;350;87523;65;266998
24599;417;703;87426;56;267701
24660;418;979;88405;24;268680
24692;419;593;88198;8;269273
24707;420;553;88751;6;269826
24723;421;649;89400;1;270475
24724;422;464;89864;54;270939
24787;423;845;90709;28;271784
24818;424;432;90341;3;272216
24834;425;506;90847;21;272722
24866;426;423;91270;25;273145
24897;427;496;91766;36;273641
24944;428;653;91619;93;274294
25051;429;492;91311;91;274786
25147;430;869;91380;66;275655
25225;431;444;91824;98;276099
25334;432;349;91373;40;276448
25381;433;945;91518;85;277393
25474;434;676;91394;93;278069
25568;435;1000;91594;20;279069
25599;436;428;92022;23;279497
25631;437;981;93003;84;280478
25724;438;943;93146;6;281421
25740;439;847;93993;41;282268
25785;440;303;93496;39;282571
25833;441;473;93969;22;283044
25864;442;858;94827;76;283902
25956;443;768;94795;43;284670
26003;444;344;94339;0;285014
26004;445;536;94875;51;285550
26064;446;456;95331;23;286006
26097;447;844;96175;47;286850
26158;448;316;95691;59;287166
26222;449;966;95857;100;288132
26332;450;349;95406;64;288481
26412;451;617;96023;98;289098
26519;452;598;95821;9;289696
26535;453;678;96499;92;290374
26629;454;979;96678;41;291353
26676;455;846;96724;86;292199
26769;456;976;96900;19;293175
26801;457;978;97878;64;294153
26878;458;302;97380;65;294455
26956;459;558;97938;73;295013
27034;460;876;98014;51;295889
27094;461;554;97768;82;296443
27188;462;947;98715;41;297390
27236;463;416;98331;35;297806
27283;464;776;99107;51;298582
27344;465;340;98647;31;298922
27376;466;649;99296;17;299571
27408;467;846;100142;65;300417
27486;468;900;100242;54;301317
27548;469;633;100075;23;301950
27578;470;854;100929;14;302804
27594;471;756;101685;4;303560
27610;472;675;102360;46;304235
27672;473;826;102386;65;305061
27750;474;475;102061;39;305536
27796;475;589;102650;95;306125
27906;476;747;102597;92;306872
27998;477;802;102599;17;307674
28031;478;934;103533;40;308608
28078;479;404;103137;33;309012
28126;480;562;103699;3;309574
28142;481;736;104435;21;310310
28174;482;807;105242;66;311117
28251;483;730;105172;3;311847
28266;484;493;105665;89;312340
28359;485;685;105550;85;313025
28453;486;324;105074;30;313349
28484;487;637;105711;84;313986
28579;488;883;105794;99;314869
28687;489;992;105986;32;315861
28732;490;580;105766;65;316441
28812;491;437;106203;88;316878
28904;492;990;106393;42;317868
28951;493;967;106560;12;318835
28968;494;762;107322;56;319597
29029;495;993;108315;94;320590
29136;496;821;108336;3;321411
29153;497;753;109089;8;322164
29168;498;606;108895;92;322770
29262;499;702;109597;11;323472
29277;500;123;108920;85;323595
29371;501;92;109012;6;323687
29386;502;106;108318;21;323793
29417;503;118;108436;53;323911
29479;504;151;108587;80;324062
29571;505;175;107962;51;324237
29632;506;182;107344;52;324419
29694;507;72;107416;46;324491
29756;508;155;106771;8;324646
29771;509;134;106905;94;324780
29876;510;181;106286;90;324961
29970;511;83;105569;59;325044
30032;512;74;104843;9;325118
30048;513;70;104913;74;325188
30126;514;106;105019;84;325294
30220;515;176;104395;98;325470
30327;516;68;103663;34;325538
30375;517;180;103043;42;325718
30421;518;94;103137;23;325812
30453;519;91;103228;76;325903
30531;520;163;102591;34;326066
30578;521;71;101862;24;326137
30609;522;112;101974;53;326249
30670;523;139;102113;98;326388
30779;524;112;101425;34;326500
30825;525;184;100809;5;326684
30841;526;73;100882;44;326757
30887;527;86;100968;90;326843
30980;528;182;100350;46;327025
31027;529;137;99687;57;327162
31091;530;92;99779;50;327254
31152;531;87;99066;98;327341
31261;532;162;98428;14;327503
31277;533;179;98607;94;327682
31386;534;94;97901;17;327776
31418;535;65;97966;71;327841
31497;536;130;97296;70;327971
31576;537;139;96635;51;328110
31636;538;153;96788;20;328263
31667;539;168;96156;26;328431
31699;540;153;96309;22;328584
31730;541;171;96480;57;328755
31792;542;160;95840;8;328915
31808;543;163;96003;51;329078
31870;544;156;96159;38;329234
31916;545;135;95494;95;329369
32026;546;183;94877;28;329552
32056;547;84;94961;46;329636
32117;548;162;94323;54;329798
32179;549;152;94475;29;329950
32209;550;111;93786;80;330061
32303;551;79;93865;44;330140
32350;552;153;93218;63;330293
32414;553;64;92482;19;330357
32444;554;187;92669;59;330544
32506;555;65;92734;14;330609
32522;556;88;92822;86;330697
32614;557;99;92121;8;330796
32629;558;127;92248;21;330923
32661;559;162;91610;33;331085
32708;560;135;91745;62;331220
32784;561;137;91082;98;331357
32895;562;192;90474;55;331549
32958;563;146;90620;8;331695
32973;564;181;90001;51;331876
33036;565;179;90180;14;332055
33051;566;195;90375;76;332250
33129;567;187;89762;35;332437
33175;568;126;89888;34;332563
33221;569;86;89174;94;332649
33329;570;139;88513;78;332788
33421;571;74;87787;71;332862
33498;572;70;87857;18;332932
33528;573;108;87165;23;333040
33558;574;117;87282;16;333157
33589;575;174;87456;72;333331
33665;576;156;86812;44;333487
33712;577;77;86889;90;333564
33806;578;127;86216;73;333691
33886;579;146;85562;65;333837
33962;580;77;84839;6;333914
33977;581;114;84953;99;334028
34086;582;178;84331;69;334206
34164;583;184;83715;16;334390
34194;584;140;83855;81;334530
34287;585;61;83116;33;334591
34334;586;137;83253;86;334728
34427;587;64;82517;54;334792
34490;588;90;81807;12;334882
34505;589;79;81886;66;334961
34582;590;117;82003;81;335078
34676;591;73;81276;64;335151
34755;592;129;80605;52;335280
34816;593;200;80005;65;335480
34894;594;131;80136;85;335611
34989;595;187;79523;47;335798
35051;596;85;78808;38;335883
35097;597;101;78909;63;335984
35173;598;82;78191;54;336066
35235;599;68;78259;40;336134
35281;600;114;77573;39;336248
35328;601;112;77685;94;336360
35436;602;97;76982;0;336457
35437;603;97;77079;78;336554
35530;604;122;76401;81;336676
35624;605;91;75692;68;336767
35701;606;70;74962;31;336837
35748;607;174;75136;9;337011
35764;608;149;75285;31;337160
35795;609;125;74610;62;337285
35858;610;146;74756;100;337431
35966;611;62;74018;74;337493
36045;612;79;73297;62;337572
36108;613;110;73407;30;337682
36140;614;188;72795;53;337870
36202;615;126;72921;8;337996
36217;616;137;73058;66;338133
36296;617;64;72322;70;338197
36374;618;90;71612;12;338287
36389;619;86;71698;42;338373
36435;620;139;71837;65;338512
36512;621;185;71222;17;338697
36544;622;92;71314;50;338789
36607;623;183;70697;34;338972
36654;624;96;70793;49;339068
36715;625;173;70166;53;339241
36777;626;184;69550;3;339425
36793;627;188;69738;26;339613
36824;628;186;69924;43;339799
36870;629;103;70027;97;339902
36979;630;199;69426;24;340101
37010;631;69;68695;68;340170
37088;632;162;68857;34;340332
37135;633;146;68203;61;340478
37198;634;93;68296;57;340571
37261;635;83;67579;74;340654
37338;636;147;66926;96;340801
37448;637;200;66326;22;341001
37478;638;159;66485;49;341160
37527;639;110;65795;66;341270
37601;640;117;65912;60;341387
37662;641;195;65307;21;341582
37694;642;63;65370;43;341645
37741;643;64;65434;0;341709
37743;644;159;64793;50;341868
37802;645;126;64919;52;341994
37864;646;99;64218;14;342093
37880;647;159;64377;43;342252
37928;648;90;64467;40;342342
37973;649;186;63853;56;342528
38035;650;187;64040;49;342715
38098;651;156;63396;57;342871
38160;652;194;63590;94;343065
38269;653;126;62916;38;343191
38316;654;145;62261;21;343336
38347;655;105;62366;2;343441
38362;656;101;62467;82;343542
38457;657;144;61811;81;343686
38551;658;117;61128;90;343803
38643;659;200;60528;76;344003
38722;660;66;60594;43;344069
38769;661;91;59885;30;344160
38801;662;68;59953;59;344228
38863;663;183;59336;56;344411
38926;664;130;59466;26;344541
38956;665;195;58861;72;344736
39033;666;116;58977;83;344852
39127;667;163;58340;94;345015
39237;668;141;57681;95;345156
39345;669;174;57055;12;345330
39361;670;76;57131;26;345406
39392;671;113;56444;72;345519
39468;672;151;56595;24;345670
39498;673;148;55943;9;345818
39514;674;114;56057;22;345932
39546;675;172;56229;74;346104
39623;676;70;55499;75;346174
39701;677;87;55586;92;346261
39808;678;195;54981;20;346456
39839;679;185;54366;27;346641
39870;680;110;54476;62;346751
39934;681;89;53765;78;346840
40027;682;196;53961;37;347036
40074;683;105;53266;21;347141
40105;684;192;53458;7;347333
40120;685;149;53607;31;347482
40152;686;73;52880;83;347555
40246;687;176;53056;25;347731
40277;688;139;52395;47;347870
40339;689;74;52469;75;347944
40417;690;189;51858;43;348133
40463;691;118;51976;7;348251
40479;692;131;51307;73;348382
40558;693;73;51380;66;348455
40636;694;113;50693;11;348568
40652;695;163;50856;51;348731
40714;696;88;50144;24;348819
40745;697;132;50276;44;348951
40791;698;186;50462;41;349137
40839;699;199;49861;91;349336
40934;700;85;49146;37;349421
40981;701;188;49334;46;349609
41043;702;62;48596;1;349671
41047;703;105;48701;24;349776
41074;704;93;48794;51;349869
41136;705;70;48064;12;349939
41151;706;158;48222;42;350097
41198;707;82;48304;38;350179
41244;708;126;47630;55;350305
41306;709;135;47765;18;350440
41338;710;106;47871;99;350546
41445;711;134;47205;91;350680
41540;712;121;46526;97;350801
41649;713;147;45873;62;350948
41711;714;192;45265;71;351140
41789;715;179;44644;57;351319
41853;716;64;44708;76;351383
41930;717;150;44058;67;351533
42009;718;128;43386;40;351661
42055;719;60;43446;14;351721
42071;720;114;43560;34;351835
42116;721;90;42850;38;351925
42162;722;103;42953;86;352028
42256;723;64;42217;70;352092
42335;724;110;41527;73;352202
42415;725;197;41724;5;352399
42430;726;174;41898;53;352573
42492;727;164;41262;28;352737
42524;728;193;41455;61;352930
42585;729;101;40756;81;353031
42681;730;94;40050;4;353125
42697;731;66;40116;30;353191
42743;732;73;40189;47;353264
42790;733;182;39571;89;353446
42882;734;126;38897;91;353572
42976;735;191;39088;16;353763
43007;736;184;38472;12;353947
43022;737;186;38658;13;354133
43038;738;156;38814;73;354289
43116;739;64;38078;37;354353
43163;740;169;38247;46;354522
43210;741;106;37553;25;354628
43240;742;100;37653;98;354728
43346;743;182;37035;91;354910
43440;744;63;36298;39;354973
43488;745;178;36476;6;355151
43504;746;134;36610;82;355285
43596;747;162;35972;76;355447
43673;748;157;35329;41;355604
43719;749;169;35498;21;355773
43749;750;189;34887;50;355962
43811;751;168;35055;51;356130
43873;752;62;34317;39;356192
43919;753;128;34445;24;356320
43950;754;63;34508;52;356383
44013;755;159;33867;73;356542
44090;756;164;33231;26;356706
44122;757;191;33422;59;356897
44184;758;106;32728;96;357003
44280;759;176;32104;35;357179
44323;760;117;32221;66;357296
44400;761;197;31618;85;357493
44494;762;199;31817;66;357692
44571;763;125;31142;26;357817
44601;764;191;31333;46;358008
44648;765;137;30670;37;358145
44694;766;137;30807;89;358282
44789;767;164;30171;95;358446
44897;768;124;29495;73;358570
44977;769;76;28771;10;358646
44993;770;183;28954;70;358829
45073;771;136;28290;26;358965
45104;772;106;28396;5;359071
45119;773;78;28474;89;359149
45213;774;61;27735;51;359210
45276;775;100;27035;7;359310
45291;776;129;27164;48;359439
45354;777;181;27345;3;359620
45357;778;72;27417;63;359692
45434;779;86;26703;52;359778
45497;780;175;26078;6;359953
45513;781;125;26203;87;360078
45607;782;156;25559;3;360234
45623;783;113;25672;85;360347
45717;784;159;25031;94;360506
45812;785;110;25141;64;360616
45890;786;90;24431;0;360706
45892;787;129;24560;39;360835
45938;788;120;23880;30;360955
45969;789;165;24045;19;361120
46001;790;117;24162;38;361237
46047;791;122;23484;48;361359
46110;792;68;23552;59;361427
46172;793;149;22901;85;361576
46265;794;91;22192;68;361667
46344;795;83;22275;84;361750
46439;796;136;21611;77;361886
46517;797;172;20983;10;362058
46533;798;184;21167;54;362242
46594;799;130;20497;55;362372
46658;800;118;20615;31;362490
46691;801;146;19961;8;362636
46704;802;95;20056;75;362731
46783;803;71;20127;20;362802
46813;804;192;19519;66;362994
46893;805;194;19713;24;363188
46924;806;112;19025;41;363300
46972;807;93;19118;89;363393
47067;808;65;18383;53;363458
47129;809;193;18576;82;363651
47223;810;138;17914;79;363789
47318;811;150;17264;44;363939
47364;812;198;16662;51;364137
47426;813;147;16809;42;364284
47473;814;195;16204;41;364479
47521;815;60;16264;71;364539
47597;816;137;15601;19;364676
47629;817;78;15679;4;364754
47644;818;137;15816;38;364891
47691;819;104;15120;5;364995
47706;820;153;15273;52;365148
47767;821;62;15335;96;365210
47876;822;146;14681;89;365356
47971;823;111;13992;74;365467
48050;824;198;13390;55;365665
48113;825;61;13451;14;365726
48129;826;185;12836;51;365911
48191;827;82;12918;22;365993
48223;828;138;13056;21;366131
48254;829;157;12413;41;366288
48301;830;76;12489;7;366364
48317;831;106;12595;67;366470
48397;832;172;11967;92;366642
48490;833;63;11230;40;366705
48537;834;132;11362;14;366837
48553;835;106;11468;58;366943
48616;836;84;10752;98;367027
48725;837;110;10062;41;367137
48773;838;158;10220;47;367295
48834;839;141;9561;92;367436
48926;840;141;8902;9;367577
48942;841;162;9064;41;367739
48989;842;185;9249;22;367924
49020;843;172;8621;11;368096
49035;844;183;8804;55;368279
49097;845;126;8930;75;368405
49173;846;193;8323;35;368598
49220;847;128;7651;29;368726
49251;848;88;7739;45;368814
49298;849;165;7904;38;368979
49344;850;108;7212;40;369087
49392;851;96;7308;88;369183
49487;852;89;6597;52;369272
49549;853;165;5962;64;369437
49627;854;89;6051;55;369526
49687;855;111;5362;69;369637
49762;856;168;4730;8;369805
49778;857;163;4893;20;369968
49808;858;125;5018;51;370093
49871;859;186;4404;78;370279
49965;860;190;4594;11;370469
49980;861;106;3900;5;370575
49996;862;151;4051;5;370726
50010;863;61;4112;54;370787
50073;864;70;4182;27;370857
50104;865;68;3450;20;370925
50136;866;113;3563;4;371038
50151;867;190;3753;39;371228
50198;868;173;3126;51;371401
50259;869;85;3211;96;371486
50368;870;141;2552;49;371627
50429;871;140;1892;95;371767
50537;872;74;1166;33;371841
50583;873;141;1307;27;371982
50614;874;101;1408;45;372083
50660;875;124;732;24;372207
50691;876;160;892;3;372367
50706;877;97;989;80;372464
50800;878;135;324;1;372599
50801;879;120;444;55;372719
50862;880;184;184;36;372903
50908;881;76;260;59;372979
50970;882;67;67;10;373046
50985;883;150;217;39;373196
51031;884;87;304;27;373283
51062;885;152;152;5;373435
51077;886;80;232;15;373515
51107;887;101;333;79;373616
51199;888;76;76;24;373692
51230;889;193;269;54;373885
51292;890;116;116;18;374001
51323;891;88;204;89;374089
51415;892;104;104;53;374193
51475;893;64;168;74;374257
51553;894;94;94;23;374351
51583;895;111;205;17;374462
51615;896;162;162;92;374624
51707;897;143;143;6;374767
51723;898;94;237;49;374861
51786;899;125;362;2;374986
51789;900;117;479;32;375103
51833;901;63;63;78;375166
51912;902;169;169;55;375335
51973;903;103;272;54;375438
52035;904;102;102;92;375540
52129;905;107;209;31;375647
52175;906;157;157;9;375804
52190;907;73;230;56;375877
52251;908;92;92;87;375969
52345;909;138;230;62;376107
52423;910;146;146;49;376253
52486;911;124;124;91;376377
52578;912;149;149;9;376526
52594;913;123;272;8;376649
52610;914;129;401;52;376778
52672;915;176;577;28;376954
52702;916;87;87;100;377041
52813;917;129;129;63;377170
52891;918;182;311;67;377352
52969;919;113;113;81;377465
53062;920;114;114;43;377579
53109;921;153;267;52;377732
53173;922;145;145;33;377877
53220;923;70;215;21;377947
53251;924;95;95;92;378042
53345;925;152;152;20;378194
53376;926;192;344;73;378386
53455;927;192;192;39;378578
53502;928;99;291;59;378677
53564;929;70;70;49;378747
53626;930;144;214;27;378891
53658;931;194;408;37;379085
53703;932;127;127;98;379212
53811;933;104;104;31;379316
53843;934;105;209;48;379421
53906;935;188;188;11;379609
53921;936;100;288;89;379709
54014;937;80;80;36;379789
54061;938;200;280;77;379989
54154;939;183;183;2;380172
54156;940;131;314;74;380303
54232;941;118;118;36;380421
54279;942;150;268;45;380571
54326;943;145;145;40;380716
54372;944;79;224;75;380795
54452;945;68;68;30;380863
54484;946;176;244;67;381039
54561;947;141;141;44;381180
54607;948;193;334;45;381373
54653;949;138;138;95;381511
54749;950;171;171;26;381682
54780;951;150;321;73;381832
54858;952;106;427;54;381938
54919;953;153;153;15;382091
54949;954;192;345;3;382283
54964;955;194;539;86;382477
55060;956;186;186;11;382663
55075;957;68;254;23;382731
55107;958;104;104;56;382835
55169;959;193;297;64;383028
55247;960;143;143;21;383171
55278;961;176;319;51;383347
55341;962;188;188;40;383535
55386;963;193;381;28;383728
55418;964;99;99;69;383827
55496;965;157;256;44;383984
55543;966;106;106;4;384090
55558;967;151;257;52;384241
55621;968;79;336;31;384320
55667;969;159;159;4;384479
55682;970;116;275;56;384595
55744;971;150;150;0;384745
55745;972;155;305;18;384900
55774;973;161;466;33;385061
55821;974;167;633;72;385228
55898;975;127;127;29;385355
55929;976;169;296;49;385524
55991;977;129;129;71;385653
56070;978;152;152;97;385805
56167;979;122;122;19;385927
56196;980;171;293;11;386098
56212;981;114;407;64;386212
56277;982;85;85;50;386297
56338;983;136;221;97;386433
56446;984;193;193;78;386626
56538;985;173;173;81;386799
56633;986;142;142;3;386941
56648;987;133;275;11;387074
56664;988;133;408;74;387207
56741;989;85;85;49;387292
56804;990;173;258;29;387465
56835;991;79;79;68;387544
56913;992;171;250;72;387715
56990;993;196;196;70;387911
57068;994;175;175;91;388086
57162;995;114;114;77;388200
57241;996;132;246;90;388332
57335;997;73;73;16;388405
57365;998;83;156;14;388488
57380;999;174;174;69;388662
57458;1000;442;616;3;389104
57473;1001;646;1262;91;389750
57566;1002;329;791;0;390079
57567;1003;868;1659;11;390947
57581;1004;508;2167;33;391455
57628;1005;304;1671;54;391759
57690;1006;441;2112;43;392200
57738;1007;560;1872;63;392760
57814;1008;381;1453;24;393141
57845;1009;616;2069;52;393757
57907;1010;535;2604;57;394292
57969;1011;936;2740;0;395228
57972;1012;940;3680;55;396168
58031;1013;763;3643;22;396931
58062;1014;556;4199;11;397487
58077;1015;557;4756;33;398044
58124;1016;918;5674;23;398962
58154;1017;674;5548;87;399636
58248;1018;720;5468;43;400356
58295;1019;499;5967;40;400855
58342;1020;815;6782;71;401670
58419;1021;760;6742;63;402430
58497;1022;962;6904;97;403392
58606;1023;750;6854;24;404142
58635;1024;537;7391;45;404679
58682;1025;623;7214;24;405302
58712;1026;419;7633;51;405721
58775;1027;703;8336;38;406424
58820;1028;867;8403;19;407291
58851;1029;737;9140;56;408028
58912;1030;748;9088;41;408776
58960;1031;786;9874;94;409562
59067;1032;959;10033;47;410521
59129;1033;827;10060;35;411348
59176;1034;442;10502;44;411790
59222;1035;975;10677;71;412765
59299;1036;575;11252;77;413340
59377;1037;798;11250;82;414138
59470;1038;508;10958;31;414646
59502;1039;817;11775;52;415463
59564;1040;524;11499;87;415987
59658;1041;384;11083;35;416371
59705;1042;317;11400;55;416688
59768;1043;773;11373;10;417461
59785;1044;605;11978;41;418066
59831;1045;524;12502;65;418590
59908;1046;304;12006;7;418894
59923;1047;649;12655;58;419543
59983;1048;318;12173;29;419861
60015;1049;399;12572;58;420260
60078;1050;827;13399;5;421087
60094;1051;997;13596;61;422084
60157;1052;869;14465;44;422953
60204;1053;659;14324;95;423612
60301;1054;510;14034;81;424122
60391;1055;637;14671;85;424759
60486;1056;906;14777;48;425665
60548;1057;642;14619;22;426307
60578;1058;996;15615;21;427303
60611;1059;392;16007;69;427695
60687;1060;931;16138;7;428626
60703;1061;871;17009;16;429497
60734;1062;767;17776;10;430264
60749;1063;342;17318;52;430606
60812;1064;377;17695;39;430983
60858;1065;971;17866;71;431954
60937;1066;826;18692;72;432780
61014;1067;446;18338;65;433226
61092;1068;535;18073;90;433761
61183;1069;372;17645;17;434133
61214;1070;939;18584;5;435072
61230;1071;994;19578;62;436066
61293;1072;524;19302;61;436590
61356;1073;318;19620;94;436908
61465;1074;972;19792;69;437880
61543;1075;568;19560;25;438448
61574;1076;921;20481;25;439369
61606;1077;427;20908;90;439796
61700;1078;914;21022;97;440710
61807;1079;553;20775;34;441263
61854;1080;614;20589;2;441877
61870;1081;719;21308;56;442596
61932;1082;784;22092;61;443380
62009;1083;777;22069;4;444157
62024;1084;713;22782;64;444870
62102;1085;642;22624;98;445512
62209;1086;754;22578;60;446266
62272;1087;676;22454;100;446942
62382;1088;498;22152;55;447440
62444;1089;552;22704;5;447992
62450;1090;899;23603;19;448891
62475;1091;438;24041;34;449329
62522;1092;685;23926;48;450014
62583;1093;726;24652;38;450740
62630;1094;624;24476;79;451364
62723;1095;966;24642;85;452330
62816;1096;302;24144;19;452632
62847;1097;591;24735;57;453223
62909;1098;828;25563;31;454051
62940;1099;977;25740;53;455028
63004;1100;599;26339;77;455627
63081;1101;361;25900;28;455988
63112;1102;517;26417;39;456505
63158;1103;499;26116;66;457004
63237;1104;874;26990;92;457878
63332;1105;996;27186;47;458874
63394;1106;616;27002;41;459490
63441;1107;605;27607;80;460095
63535;1108;983;27790;80;461078
63628;1109;644;27634;74;461722
63704;1110;786;27620;28;462508
63736;1111;698;28318;46;463206
63784;1112;381;27899;48;463587
63845;1113;660;28559;4;464247
63861;1114;437;28996;87;464684
63954;1115;341;28537;67;465025
64032;1116;409;28146;7;465434
64048;1117;958;29104;32;466392
64094;1118;784;29888;97;467176
64202;1119;845;29933;94;468021
64310;1120;637;29770;53;468658
64373;1121;388;29358;3;469046
64389;1122;563;29921;59;469609
64451;1123;679;29800;33;470288
64498;1124;927;30727;56;471215
64559;1125;857;30784;91;472072
64654;1126;901;31685;93;472973
64761;1127;668;31553;75;473641
64837;1128;989;31742;89;474630
64932;1129;711;31653;19;475341
64964;1130;982;32635;63;476323
65041;1131;560;32395;86;476883
65133;1132;402;31997;23;477285
65164;1133;904;32901;67;478189
65241;1134;400;32501;42;478589
65289;1135;507;33008;97;479096
65397;1136;903;33111;20;479999
65428;1137;596;32907;48;480595
65490;1138;417;33324;41;481012
65537;1139;882;33406;4;481894
65553;1140;612;34018;22;482506
65583;1141;869;34887;1;483375
65585;1142;773;35660;34;484148
65631;1143;668;36328;63;484816
65710;1144;500;36028;16;485316
65741;1145;364;36392;54;485680
65805;1146;661;36253;43;486341
65850;1147;607;36860;60;486948
65911;1148;851;36911;48;487799
65959;1149;591;36702;26;488390
65988;1150;743;37445;27;489133
66018;1151;871;38316;95;490004
66128;1152;531;38047;65;490535
66206;1153;490;37737;67;491025
66284;1154;546;38283;28;491571
66315;1155;763;38246;52;492334
66377;1156;477;38723;65;492811
66456;1157;788;38711;53;493599
66518;1158;999;38910;13;494598
66533;1159;435;39345;44;495033
66581;1160;778;40123;48;495811
66641;1161;909;40232;54;496720
66702;1162;418;40650;50;497138
66766;1163;829;40679;49;497967
66829;1164;714;41393;15;498681
66861;1165;666;41259;76;499347
66939;1166;404;41663;29;499751
66970;1167;432;41295;27;500183
67000;1168;941;42236;59;501124
67061;1169;948;42384;53;502072
67123;1170;946;43330;99;503018
67232;1171;671;43201;7;503689
67247;1172;817;44018;3;504506
67262;1173;303;44321;79;504809
67356;1174;380;43901;88;505189
67450;1175;676;43777;22;505865
67481;1176;899;44676;16;506764
67512;1177;947;44823;40;507711
67557;1178;395;45218;96;508106
67665;1179;465;44883;12;508571
67680;1180;478;45361;23;509049
67711;1181;665;45226;94;509714
67807;1182;984;45410;74;510698
67885;1183;654;46064;77;511352
67979;1184;738;46002;32;512090
68025;1185;481;46483;77;512571
68117;1186;660;46343;70;513231
68192;1187;637;46180;17;513868
68223;1188;758;46938;58;514626
68285;1189;451;46589;3;515077
68300;1190;547;47136;30;515624
68332;1191;598;47734;11;516222
68347;1192;440;48174;31;516662
68379;1193;910;48284;31;517572
68426;1194;928;49212;28;518500
68457;1195;563;49775;83;519063
68550;1196;923;49898;96;519986
68657;1197;515;49613;45;520501
68704;1198;302;49115;31;520803
68736;1199;958;50073;92;521761
68844;1200;603;49876;39;522364
68891;1201;350;50226;73;522714
68970;1202;998;50424;57;523712
69031;1203;509;50133;72;524221
69107;1204;844;50977;72;525065
69186;1205;667;50844;49;525732
69247;1206;459;50503;65;526191
69325;1207;916;51419;62;527107
69403;1208;938;51557;82;528045
69496;1209;840;51597;68;528885
69575;1210;847;51644;44;529732
69621;1211;551;52195;90;530283
69716;1212;645;52040;3;530928
69730;1213;617;52657;93;531545
69825;1214;711;52568;68;532256
69903;1215;766;52534;40;533022
69949;1216;665;53199;94;533687
70058;1217;772;53171;23;534459
70089;1218;876;54047;17;535335
70119;1219;301;53548;7;535636
70135;1220;552;54100;76;536188
70214;1221;908;54208;55;537096
70276;1222;863;55071;19;537959
70307;1223;568;55639;54;538527
70370;1224;952;55791;7;539479
70385;1225;757;56548;31;540236
70417;1226;731;57279;20;540967
70448;1227;344;56823;51;541311
70511;1228;560;57383;57;541871
70572;1229;928;57511;27;542799
70604;1230;888;58399;81;543687
70699;1231;837;58436;71;544524
70776;1232;644;58280;42;545168
70823;1233;676;58956;4;545844
70838;1234;429;59385;44;546273
70885;1235;414;58999;14;546687
70900;1236;378;59377;16;547065
70931;1237;709;60086;14;547774
70946;1238;926;61012;44;548700
70993;1239;532;60744;57;549232
71056;1240;945;61689;91;550177
71150;1241;744;61633;74;550921
71226;1242;987;61820;3;551908
71241;1243;893;62713;100;552801
71352;1244;890;62803;7;553691
71367;1245;541;63344;64;554232
71444;1246;706;63250;8;554938
71460;1247;588;63838;77;555526
71538;1248;927;63965;99;556453
71647;1249;396;63561;21;556849
71678;1250;413;63974;9;557262
71694;1251;926;64900;17;558188
71726;1252;913;65813;6;559101
71741;1253;399;65412;79;559500
71833;1254;790;66202;38;560290
71881;1255;314;65716;49;560604
71942;1256;991;66707;42;561595
71990;1257;632;66539;1;562227
71991;1258;777;67316;36;563004
72038;1259;624;67940;63;563628
72102;1260;942;68082;42;564570
72148;1261;326;68408;99;564896
72257;1262;419;68027;30;565315
72287;1263;770;67997;65;566085
72367;1264;566;68563;41;566651
72412;1265;523;68286;30;567174
72444;1266;653;68939;21;567827
72475;1267;621;69560;75;568448
72554;1268;456;69216;93;568904
72664;1269;668;69084;60;569572
72725;1270;739;69023;4;570311
72741;1271;637;69660;7;570948
72756;1272;347;70007;2;571295
72758;1273;538;70545;83;571833
72849;1274;546;70291;57;572379
72909;1275;442;70733;60;572821
72972;1276;648;70581;58;573469
73033;1277;592;71173;37;574061
73080;1278;385;70758;77;574446
73158;1279;334;70292;60;574780
73220;1280;335;70627;56;575115
73283;1281;973;70800;87;576088
73380;1282;659;70659;21;576747
73411;1283;842;71501;80;577589
73505;1284;880;71581;59;578469
73568;1285;646;72227;39;579115
73613;1286;501;71928;40;579616
73660;1287;831;72759;21;580447
73690;1288;821;73580;3;581268
73706;1289;910;73690;74;582178
73785;1290;656;74346;86;582834
73879;1291;738;74284;39;583572
73925;1292;572;74056;17;584144
73956;1293;336;74392;12;584480
73972;1294;412;74804;54;584892
74033;1295;669;74673;85;585561
74127;1296;640;75313;50;586201
74188;1297;448;74961;6;586649
74203;1298;730;75691;24;587379
74234;1299;610;76301;98;587989
74344;1300;807;76308;87;588796
74438;1301;784;76292;46;589580
74486;1302;491;75983;76;590071
74564;1303;611;76594;92;590682
74658;1304;452;76246;59;591134
74721;1305;863;76309;86;591997
74812;1306;623;76132;66;592620
74889;1307;998;77130;84;593618
74983;1308;934;77264;70;594552
75061;1309;387;76851;62;594939
75138;1310;570;76621;66;595509
75204;1311;337;76158;56;595846
75262;1312;912;77070;69;596758
75337;1313;399;76669;32;597157
75384;1314;786;77455;37;597943
75430;1315;320;76975;64;598263
75509;1316;557;77532;53;598820
75572;1317;947;77679;93;599767
75681;1318;850;77729;24;600617
75711;1319;454;78183;81;601071
75803;1320;445;77828;6;601516
75818;1321;617;78445;3;602133
75832;1322;581;79026;86;602714
75927;1323;711;78937;78;603425
76020;1324;849;78986;26;604274
76051;1325;817;79803;16;605091
76081;1326;889;79892;28;605980
76113;1327;468;80360;88;606448
76206;1328;636;80196;85;607084
76299;1329;392;79788;71;607476
76377;1330;877;80665;7;608353
76392;1331;728;80593;34;609081
76439;1332;645;81238;45;609726
76486;1333;630;81868;89;610356
76581;1334;561;81629;58;610917
76644;1335;941;81770;89;611858
76737;1336;394;81364;5;612252
76753;1337;473;81837;61;612725
76815;1338;569;82406;71;613294
76895;1339;697;82303;40;613991
76941;1340;733;82236;78;614724
77035;1341;354;82590;65;615078
77111;1342;388;82178;75;615466
77189;1343;622;82000;76;616088
77267;1344;601;81801;19;616689
77299;1345;533;82334;11;617222
77314;1346;762;83096;11;617984
77329;1347;354;83450;5;618338
77344;1348;741;84191;2;619079
77360;1349;570;84761;40;619649
77406;1350;602;84563;59;620251
77471;1351;433;84996;29;620684
77501;1352;764;84960;84;621448
77594;1353;666;84826;61;622114
77657;1354;929;85755;19;623043
77688;1355;396;86151;39;623439
77735;1356;542;85893;73;623981
77814;1357;501;85594;81;624482
77907;1358;476;86070;49;624958
77967;1359;364;85634;7;625322
77982;1360;818;86452;45;626140
78028;1361;898;86550;56;627038
78088;1362;371;86921;53;627409
78150;1363;829;86950;92;628238
78244;1364;686;86836;66;628924
78321;1365;397;87233;80;629321
78414;1366;906;87339;91;630227
78507;1367;769;87308;10;630996
78521;1368;662;87970;74;631658
78600;1369;614;87784;70;632272
78678;1370;596;87580;61;632868
78740;1371;347;87927;70;633215
78816;1372;645;87772;14;633860
78831;1373;523;88295;63;634383
78909;1374;628;88123;28;635011
78940;1375;432;88555;13;635443
78955;1376;570;89125;92;636013
79050;1377;811;89136;17;636824
79081;1378;990;90126;80;637814
79177;1379;651;89977;14;638465
79193;1380;791;90768;9;639256
79209;1381;994;91762;19;640250
79240;1382;316;91278;25;640566
79271;1383;678;91956;38;641244
79318;1384;545;92501;29;641789
79349;1385;902;92603;58;642691
79412;1386;490;93093;94;643181
79521;1387;672;92965;41;643853
79566;1388;762;92927;36;644615
79612;1389;798;93725;43;645413
79657;1390;985;93910;36;646398
79704;1391;896;94806;93;647294
79812;1392;642;94648;99;647936
79922;1393;846;94694;86;648782
80016;1394;510;94404;59;649292
80080;1395;661;95065;80;649953
80172;1396;736;95001;59;650689
80234;1397;375;94576;19;651064
80265;1398;648;95224;43;651712
80311;1399;764;95188;34;652476
80357;1400;512;95700;51;652988
80409;1401;922;95822;46;653910
80468;1402;960;96782;91;654870
80561;1403;841;96823;60;655711
80622;1404;311;97134;1;656022
80626;1405;718;97052;89;656740
80731;1406;837;97889;30;657577
80762;1407;534;97623;75;658111
80840;1408;395;98018;27;658506
80871;1409;327;97545;15;658833
80886;1410;886;98431;3;659719
80902;1411;950;99381;28;660669
80934;1412;514;99895;37;661183
80981;1413;967;100062;5;662150
80996;1414;954;101016;90;663104
81089;1415;708;100924;77;663812
81168;1416;853;101777;65;664665
81244;1417;901;101878;83;665566
81337;1418;701;101779;35;666267
81383;1419;763;102542;54;667030
81443;1420;591;102333;40;667621
81490;1421;817;103150;99;668438
81599;1422;430;102780;42;668868
81646;1423;987;102967;18;669855
81676;1424;1000;103967;66;670855
81754;1425;670;103837;55;671525
81816;1426;774;104611;41;672299
81864;1427;770;104581;72;673069
81943;1428;462;104243;16;673531
81974;1429;481;104724;79;674012
82065;1430;511;104435;7;674523
82080;1431;567;105002;5;675090
82095;1432;801;105803;61;675891
82157;1433;620;105623;2;676511
82159;1434;395;106018;43;676906
82204;1435;533;106551;47;677439
82254;1436;808;106559;5;678247
82266;1437;578;107137;51;678825
82328;1438;357;107494;86;679182
82422;1439;391;107085;44;679573
82469;1440;587;107672;96;680160
82578;1441;339;107211;96;680499
82687;1442;946;107357;70;681445
82765;1443;413;106970;35;681858
82812;1444;506;106676;32;682364
82858;1445;933;107609;31;683297
82890;1446;414;108023;56;683711
82951;1447;983;108206;56;684694
83014;1448;426;108632;54;685120
83077;1449;831;108663;36;685951
83123;1450;535;109198;40;686486
83171;1451;569;108967;19;687055
83201;1452;928;109895;38;687983
83248;1453;360;109455;92;688343
83344;1454;849;109504;26;689192
83371;1455;457;109961;22;689649
83401;1456;923;110884;30;690572
83433;1457;813;111697;29;691385
83464;1458;489;111386;69;691874
83543;1459;452;111838;7;692326
83558;1460;383;112221;84;692709
83653;1461;867;112288;44;693576
83699;1462;610;112098;17;694186
83729;1463;939;113037;65;695125
83807;1464;519;112756;96;695644
83917;1465;815;112771;83;696459
84009;1466;504;112475;50;696963
84073;1467;926;113401;97;697889
84182;1468;537;113138;81;698426
84274;1469;444;112782;83;698870
84365;1470;562;112544;61;699432
84428;1471;406;112950;90;699838
84520;1472;918;113068;23;700756
84552;1473;830;113098;34;701586
84598;1474;513;113611;67;702099
84675;1475;321;113132;1;702420
84677;1476;323;113455;15;702743
84706;1477;448;113903;18;703191
84738;1478;994;114897;71;704185
84816;1479;982;115079;88;705167
84908;1480;416;114695;16;705583
84940;1481;491;115186;11;706074
84956;1482;588;115774;13;706662
84971;1483;403;116177;32;707065
85018;1484;556;115933;63;707621
85085;1485;331;115464;3;707952
85096;1486;822;116286;41;708774
85143;1487;437;116723;21;709211
85175;1488;539;117262;48;709750
85236;1489;851;117313;93;710601
85344;1490;431;116944;20;711032
85375;1491;767;117711;11;711799
85390;1492;582;118293;76;712381
85468;1493;947;118440;53;713328
85531;1494;432;118072;91;713760
85625;1495;365;118437;50;714125
85687;1496;459;118096;54;714584
85750;1497;863;118159;41;715447
85798;1498;818;118977;56;716265
85860;1499;894;119071;7;717159
85876;1500;112;119183;51;717271
85939;1501;124;119307;41;717395
85985;1502;74;118581;23;717469
86017;1503;164;118745;22;717633
86048;1504;88;118833;17;717721
86065;1505;90;118123;68;717811
86140;1506;169;118292;92;717980
86233;1507;82;117574;35;718062
86279;1508;200;117774;55;718262
86341;1509;117;117091;43;718379
86387;1510;185;117276;62;718564
86451;1511;103;116579;26;718667
86482;1512;200;116779;6;718867
86498;1513;191;116970;38;719058
86544;1514;156;116326;17;719214
86575;1515;164;116490;93;719378
86668;1516;148;115838;21;719526
86699;1517;106;115944;54;719632
86762;1518;153;115297;56;719785
86826;1519;77;115374;52;719862
86888;1520;106;114680;65;719968
86965;1521;134;114014;49;720102
87028;1522;127;114141;78;720229
87120;1523;109;113450;10;720338
87136;1524;164;113614;57;720502
87199;1525;66;112880;39;720568
87246;1526;91;112971;57;720659
87309;1527;66;112237;8;720725
87324;1528;162;112399;51;720887
87375;1529;103;111702;98;720990
87482;1530;188;111890;52;721178
87545;1531;146;111236;13;721324
87560;1532;146;111382;21;721470
87591;1533;153;111535;16;721623
87622;1534;177;110912;31;721800
87669;1535;122;111034;61;721922
87731;1536;71;110305;23;721993
87762;1537;84;110389;22;722077
87793;1538;82;110471;0;722159
87794;1539;167;110638;96;722326
87902;1540;111;109949;56;722437
87964;1541;132;109281;37;722569
88012;1542;92;109373;40;722661
88059;1543;196;108769;93;722857
88167;1544;120;108089;91;722977
88259;1545;81;107370;25;723058
88290;1546;96;107466;79;723154
88383;1547;82;106748;46;723236
88443;1548;104;106852;67;723340
88520;1549;114;106166;16;723454
88551;1550;134;106300;73;723588
88630;1551;169;105669;83;723757
88721;1552;69;104938;47;723826
88783;1553;62;105000;95;723888
88892;1554;70;104270;83;723958
88986;1555;107;103577;0;724065
88988;1556;196;103773;67;724261
89064;1557;122;103095;68;724383
89143;1558;197;102492;72;724580
89222;1559;130;102622;82;724710
89315;1560;131;101953;11;724841
89331;1561;108;102061;73;724949
89408;1562;63;101324;34;725012
89442;1563;178;100702;63;725190
89517;1564;151;100853;91;725341
89610;1565;121;100174;62;725462
89673;1566;99;99473;98;725561
89782;1567;170;98843;59;725731
89844;1568;90;98933;59;725821
89906;1569;134;98267;72;725955
89984;1570;109;98376;41;726064
90030;1571;111;97687;2;726175
90032;1572;68;97755;49;726243
90092;1573;105;97860;6;726348
90107;1574;197;97257;81;726545
90201;1575;176;97433;41;726721
90248;1576;138;96771;2;726859
90250;1577;143;96914;22;727002
90279;1578;115;97029;100;727117
90389;1579;151;96380;60;727268
90452;1580;93;95673;30;727361
90497;1581;77;95750;57;727438
90558;1582;120;95070;38;727558
90605;1583;178;95248;38;727736
90651;1584;100;94548;54;727836
90713;1585;158;94706;15;727994
90743;1586;75;94781;38;728069
90790;1587;92;94073;76;728161
90867;1588;76;93349;83;728237
90960;1589;120;93469;60;728357
91022;1590;135;92804;14;728492
91037;1591;190;92994;81;728682
91131;1592;76;92270;77;728758
91209;1593;88;91558;53;728846
91271;1594;62;91620;23;728908
91302;1595;87;90907;59;728995
91364;1596;181;91088;57;729176
91427;1597;116;90404;40;729292
91475;1598;127;90531;22;729419
91505;1599;131;90662;75;729550
91582;1600;137;89999;75;729687
91661;1601;167;89366;78;729854
91741;1602;175;88741;60;730029
91802;1603;182;88923;40;730211
91849;1604;126;88249;79;730337
91942;1605;102;88351;88;730439
92037;1606;82;87633;62;730521
92113;1607;113;86946;42;730634
92158;1608;187;87133;73;730821
92235;1609;71;86404;20;730892
92268;1610;142;86546;10;731034
92283;1611;157;85903;87;731191
92377;1612;193;86096;24;731384
92408;1613;186;85482;91;731570
92500;1614;114;84796;16;731684
92515;1615;165;84961;11;731849
92531;1616;132;85093;17;731981
92562;1617;151;85244;80;732132
92655;1618;106;84550;11;732238
92671;1619;195;84745;39;732433
92717;1620;127;84072;45;732560
92778;1621;80;84152;95;732640
92885;1622;142;83494;38;732782
92932;1623;135;82829;39;732917
92979;1624;119;82948;65;733036
93058;1625;77;82225;18;733113
93090;1626;132;82357;89;733245
93182;1627;157;81714;92;733402
93289;1628;104;81018;97;733506
93397;1629;77;80295;21;733583
93428;1630;184;80479;51;733767
93489;1631;74;79753;24;733841
93520;1632;79;79832;98;733920
93628;1633;157;79189;70;734077
93705;1634;123;78512;10;734200
93721;1635;87;78599;89;734287
93814;1636;118;77917;11;734405
93829;1637;190;78107;1;734595
93830;1638;111;78218;26;734706
93860;1639;101;78319;66;734807
93936;1640;190;77709;46;734997
93983;1641;123;77832;65;735120
94059;1642;115;77147;85;735235
94151;1643;178;76525;53;735413
94213;1644;61;76586;83;735474
94308;1645;68;75854;35;735542
94354;1646;181;75235;70;735723
94432;1647;153;75388;89;735876
94526;1648;132;74720;7;736008
94541;1649;70;74790;3;736078
94544;1650;68;74058;11;736146
94556;1651;120;74178;62;736266
94620;1652;101;74279;13;736367
94635;1653;138;74417;38;736505
94682;1654;84;73701;30;736589
94712;1655;122;73823;69;736711
94790;1656;87;73110;86;736798
94884;1657;88;72398;98;736886
94991;1658;127;71725;52;737013
95055;1659;119;71844;59;737132
95117;1660;91;71135;22;737223
95148;1661;83;71218;63;737306
95211;1662;62;70480;38;737368
95258;1663;91;70571;14;737459
95273;1664;162;70733;80;737621
95366;1665;82;70015;48;737703
95416;1666;131;69346;83;737834
95506;1667;71;69417;88;737905
95600;1668;98;68715;32;738003
95633;1669;129;68044;63;738132
95709;1670;90;68134;7;738222
95724;1671;140;68274;19;738362
95756;1672;174;67648;79;738536
95848;1673;63;67711;16;738599
95864;1674;152;67063;89;738751
95956;1675;89;67152;14;738840
95972;1676;156;66508;75;738996
96048;1677;180;66688;49;739176
96110;1678;178;66066;34;739354
96157;1679;156;66222;60;739510
96220;1680;71;65493;30;739581
96252;1681;177;65670;1;739758
96253;1682;159;65829;10;739917
96267;1683;132;65961;50;740049
96329;1684;123;65284;29;740172
96360;1685;98;65382;49;740270
96421;1686;91;64673;91;740361
96513;1687;94;63967;82;740455
96608;1688;110;64077;16;740565
96639;1689;121;63398;75;740686
96715;1690;143;63541;67;740829
96795;1691;90;62831;49;740919
96857;1692;134;62165;58;741053
96920;1693;104;62269;3;741157
96935;1694;197;62466;33;741354
96980;1695;142;61808;9;741496
96995;1696;96;61904;16;741592
97026;1697;130;62034;62;741722
97089;1698;101;61335;61;741823
97152;1699;93;61428;76;741916
97231;1700;73;60701;96;741989
97338;1701;190;60091;13;742179
97353;1702;138;60229;92;742317
97448;1703;191;59620;10;742508
97463;1704;92;59712;4;742600
97479;1705;152;59864;76;742752
97558;1706;163;59227;49;742915
97619;1707;197;58624;36;743112
97667;1708;188;58812;27;743300
97699;1709;95;58907;41;743395
97745;1710;100;58207;82;743495
97839;1711;82;57489;42;743577
97885;1712;145;57634;13;743722
97901;1713;164;57798;86;743886
97993;1714;175;57173;85;744061
98086;1715;123;56496;61;744184
98149;1716;83;55779;97;744267
98246;1717;78;55057;20;744345
98274;1718;152;55209;36;744497
98321;1719;171;55380;97;744668
98428;1720;108;54688;39;744776
98474;1721;74;53962;31;744850
98520;1722;168;54130;1;745018
98520;1723;110;54240;44;745128
98566;1724;169;54409;51;745297
98629;1725;86;53695;12;745383
98644;1726;162;53857;77;745545
98736;1727;99;53156;90;745644
98830;1728;193;52549;25;745837
98861;1729;71;52620;81;745908
98956;1730;156;51976;65;746064
99034;1731;150;51326;81;746214
99115;1732;166;50692;49;746380
99173;1733;121;50813;60;746501
99235;1734;170;50183;65;746671
99312;1735;187;50370;76;746858
99389;1736;180;49750;30;747038
99421;1737;118;49868;51;747156
99483;1738;123;49191;52;747279
99545;1739;110;49301;62;747389
99608;1740;80;48581;52;747469
99670;1741;140;47921;16;747609
99699;1742;99;48020;42;747708
99747;1743;78;48098;44;747786
99793;1744;149;47447;25;747935
99823;1745;108;47555;69;748043
99902;1746;123;46878;27;748166
99933;1747;177;47055;98;748343
100043;1748;128;46383;40;748471
100089;1749;143;46526;36;748614
100136;1750;102;45828;86;748716
100230;1751;131;45159;56;748847
100292;1752;106;45265;36;748953
100338;1753;66;44531;46;749019
100399;1754;65;44596;34;749084
100444;1755;74;43870;74;749158
100523;1756;179;44049;56;749337
100587;1757;110;43359;41;749447
100632;1758;140;43499;23;749587
100663;1759;151;42850;23;749738
100694;1760;189;43039;23;749927
100725;1761;68;43107;92;749995
100833;1762;153;42460;68;750148
100909;1763;70;41730;13;750218
100925;1764;61;41791;58;750279
100988;1765;184;41175;94;750463
101082;1766;157;40532;57;750620
101144;1767;181;40713;11;750801
101159;1768;146;40859;8;750947
101175;1769;77;40936;26;751024
101207;1770;172;40308;14;751196
101222;1771;187;40495;10;751383
101238;1772;139;40634;95;751522
101346;1773;69;39903;40;751591
101392;1774;149;40052;87;751740
101485;1775;64;39316;64;751804
101562;1776;141;38657;41;751945
101609;1777;170;38827;50;752115
101670;1778;117;38144;89;752232
101764;1779;126;37470;31;752358
101795;1780;89;37559;63;752447
101873;1781;63;36822;17;752510
101904;1782;74;36896;84;752584
101999;1783;67;36163;96;752651
102108;1784;153;35516;18;752804
102140;1785;162;35678;89;752966
102235;1786;194;35072;100;753160
102344;1787;169;34441;91;753329
102438;1788;102;33743;94;753431
102547;1789;184;33127;8;753615
102563;1790;132;33259;83;753747
102658;1791;159;32618;40;753906
102705;1792;77;32695;51;753983
102768;1793;148;32043;66;754131
102844;1794;154;31397;31;754285
102876;1795;117;31514;53;754402
102939;1796;143;30857;60;754545
103002;1797;87;30944;64;754632
103078;1798;185;30329;47;754817
103140;1799;158;30487;4;754975
103156;1800;96;29783;20;755071
103187;1801;117;29900;78;755188
103280;1802;160;29260;89;755348
103375;1803;118;28578;25;755466
103405;1804;83;28661;92;755549
103497;1805;96;27957;8;755645
103513;1806;120;28077;43;755765
103560;1807;93;28170;56;755858
103621;1808;99;27469;4;755957
103637;1809;177;27646;89;756134
103730;1810;77;26923;22;756211
103761;1811;128;27051;59;756339
103822;1812;154;26405;77;756493
103901;1813;91;26496;60;756584
103963;1814;64;25760;57;756648
104025;1815;99;25059;74;756747
104103;1816;190;25249;23;756937
104134;1817;139;24588;100;757076
104242;1818;84;23872;67;757160
104320;1819;136;24008;60;757296
104382;1820;108;23316;67;757404
104458;1821;109;22625;29;757513
104490;1822;71;22696;40;757584
104536;1823;88;22784;84;757672
104631;1824;101;22085;38;757773
104675;1825;67;21352;24;757840
104706;1826;106;21458;43;757946
104753;1827;109;21567;70;758055
104831;1828;108;20875;41;758163
104878;1829;93;20968;70;758256
104957;1830;151;20319;42;758407
105004;1831;68;19587;41;758475
105051;1832;61;19648;89;758536
105144;1833;129;18977;17;758665
105176;1834;84;19061;30;758749
105209;1835;82;19143;97;758831
105320;1836;79;18422;52;758910
105383;1837;111;17733;61;759021
105447;1838;141;17074;11;759162
105463;1839;84;17158;74;759246
105542;1840;173;17331;10;759419
105558;1841;171;16702;38;759590
105605;1842;92;16794;9;759682
105620;1843;62;16856;10;759744
105636;1844;169;17025;54;759913
105700;1845;72;16297;60;759985
105765;1846;152;16449;81;760137
105859;1847;105;15754;69;760242
105938;1848;79;15033;77;760321
106016;1849;102;14335;56;760423
106080;1850;151;14486;22;760574
106110;1851;172;13858;6;760746
106125;1852;152;14010;52;760898
106189;1853;82;14092;10;760980
106205;1854;101;14193;74;761081
106284;1855;122;13515;96;761203
106392;1856;91;12806;67;761294
106469;1857;97;12103;42;761391
106516;1858;75;12178;4;761466
106532;1859;176;12354;87;761642
106625;1860;181;11735;95;761823
106736;1861;86;11021;65;761909
106814;1862;151;10372;64;762060
106893;1863;66;9638;92;762126
106988;1864;115;8953;18;762241
107019;1865;87;9040;56;762328
107081;1866;86;9126;66;762414
107160;1867;105;8431;76;762519
107239;1868;88;7719;69;762607
107307;1869;118;7037;65;762725
107379;1870;111;7148;44;762836
107426;1871;171;6519;85;763007
107519;1872;177;6696;46;763184
107566;1873;131;6027;41;763315
107612;1874;165;6192;71;763480
107690;1875;148;5540;54;763628
107752;1876;110;4850;85;763738
107845;1877;94;4944;88;763832
107939;1878;151;4295;10;763983
107955;1879;156;4451;13;764139
107971;1880;106;3757;49;764245
108035;1881;121;3878;99;764366
108143;1882;137;3215;87;764503
108236;1883;166;2581;34;764669
108284;1884;196;2777;87;764865
108378;1885;105;2082;28;764970
108409;1886;61;1343;13;765031
108425;1887;83;1426;46;765114
108472;1888;199;1625;79;765313
108565;1889;137;962;3;765450
108580;1890;67;1029;7;765517
108596;1891;97;1126;91;765614
108688;1892;62;388;61;765676
108751;1893;69;69;93;765745
108859;1894;86;86;3;765831
108874;1895;178;264;9;766009
108889;1896;69;333;18;766078
108920;1897;152;485;96;766230
109028;1898;82;82;5;766312
109043;1899;140;222;77;766452
109123;1900;169;169;25;766621
109154;1901;155;324;71;766776
109232;1902;183;183;12;766959
109248;1903;102;285;16;767061
109266;1904;74;74;43;767135
109310;1905;186;260;41;767321
109357;1906;61;321;71;767382
109435;1907;109;109;12;767491
109450;1908;68;177;64;767559
109528;1909;178;178;6;767737
109543;1910;167;345;21;767904
109574;1911;66;411;3;767970
109590;1912;123;534;7;768093
109606;1913;116;116;52;768209
109667;1914;170;286;33;768379
109700;1915;90;90;10;768469
109714;1916;65;155;66;768534
109792;1917;85;240;78;768619
109870;1918;74;74;65;768693
109948;1919;142;142;43;768835
109993;1920;61;203;4;768896
110009;1921;67;270;25;768963
110040;1922;155;155;95;769118
110136;1923;144;144;38;769262
110180;1924;148;292;54;769410
110244;1925;143;435;61;769553
110305;1926;146;146;56;769699
110367;1927;161;161;55;769860
110429;1928;180;341;87;770040
110522;1929;70;70;32;770110
110570;1930;71;141;91;770181
110676;1931;108;108;90;770289
110771;1932;116;116;87;770405
110863;1933;154;154;47;770559
110911;1934;164;164;63;770723
110988;1935;123;287;55;770846
111051;1936;92;92;24;770938
111081;1937;95;187;51;771033
111143;1938;158;158;17;771191
111175;1939;137;295;38;771328
111222;1940;117;412;26;771445
111252;1941;176;176;84;771621
111345;1942;192;192;27;771813
111376;1943;63;255;20;771876
111407;1944;66;321;93;771942
111514;1945;70;70;9;772012
111528;1946;130;200;90;772142
111623;1947;180;180;40;772322
111670;1948;124;124;26;772446
111701;1949;165;289;31;772611
111749;1950;167;456;10;772778
111763;1951;91;547;66;772869
111841;1952;165;165;76;773034
111919;1953;92;92;12;773126
111934;1954;78;170;14;773204
111950;1955;171;341;87;773375
112042;1956;180;180;36;773555
112089;1957;153;333;0;773708
112091;1958;190;190;88;773898
112183;1959;184;374;59;774082
112244;1960;196;196;66;774278
112310;1961;90;90;44;774368
112370;1962;75;165;66;774443
112447;1963;127;127;23;774570
112477;1964;103;230;55;774673
112539;1965;176;176;41;774849
112586;1966;191;367;7;775040
112602;1967;195;562;86;775235
112694;1968;75;75;1;775310
112695;1969;118;193;52;775428
112755;1970;110;110;8;775538
112772;1971;196;306;26;775734
112801;1972;192;498;40;775926
112847;1973;136;634;45;776062
112893;1974;90;90;72;776152
112970;1975;199;199;25;776351
113002;1976;127;326;48;776478
113064;1977;65;391;54;776543
113127;1978;76;76;88;776619
113220;1979;195;195;6;776814
113236;1980;63;258;14;776877
113251;1981;68;326;15;776945
113266;1982;111;437;42;777056
113312;1983;154;154;0;777210
113313;1984;128;282;22;777338
113343;1985;189;471;6;777527
113358;1986;155;626;3;777682
113373;1987;169;795;41;777851
113419;1988;81;81;69;777932
113497;1989;185;266;11;778117
113513;1990;119;119;31;778236
113560;1991;107;226;60;778343
113622;1992;117;117;56;778460
113684;1993;67;184;24;778527
113715;1994;163;347;89;778690
113810;1995;165;165;32;778855
113857;1996;146;146;73;779001
113936;1997;144;290;10;779145
113951;1998;123;123;66;779268
114027;1999;84;207;12;779352
114043;2000;702;909;77;780054
114120;2001;358;467;42;780412
114167;2002;362;362;9;780774
114182;2003;447;809;20;781221
114214;2004;900;1709;15;782121
114230;2005;468;2177;82;782589
114323;2006;687;2064;91;783276
114416;2007;394;1658;17;783670
114447;2008;388;2046;38;784058
114494;2009;797;2043;69;784855
114573;2010;353;2396;35;785208
114619;2011;948;2544;82;786156
114711;2012;805;2549;21;786961
114742;2013;454;3003;72;787415
114819;2014;989;3192;88;788404
114912;2015;386;3578;12;788790
114926;2016;765;3543;70;789555
115005;2017;959;4502;17;790514
115022;2018;332;4034;26;790846
115052;2019;633;4667;39;791479
115100;2020;611;5278;79;792090
115192;2021;923;5401;79;793013
115286;2022;665;5266;77;793678
115379;2023;998;5464;8;794676
115395;2024;804;6268;81;795480
115490;2025;465;5933;56;795945
115553;2026;984;6917;57;796929
115617;2027;835;6952;18;797764
115648;2028;518;7470;96;798282
115756;2029;322;6992;96;798604
115864;2030;333;6525;9;798937
115879;2031;786;7311;34;799723
115926;2032;809;7320;97;800532
116034;2033;652;7172;11;801184
116051;2034;368;7540;23;801552
116082;2035;395;7935;47;801947
116144;2036;689;7824;31;802636
116176;2037;427;8251;4;803063
116192;2038;779;9030;10;803842
116208;2039;443;9473;27;804285
116238;2040;599;9272;6;804884
116254;2041;628;9900;30;805512
116285;2042;441;10341;2;805953
116288;2043;855;11196;17;806808
116316;2044;649;11845;45;807457
116376;2045;686;11731;74;808143
116453;2046;706;11637;88;808849
116545;2047;547;12184;63;809396
116623;2048;874;12258;55;810270
116685;2049;964;12422;34;811234
116731;2050;568;12990;93;811802
116838;2051;708;12898;43;812510
116885;2052;311;12409;15;812821
116900;2053;407;12816;70;813228
116980;2054;669;13485;98;813897
117088;2055;446;13131;43;814343
117136;2056;593;12924;46;814936
117183;2057;825;13749;51;815761
117245;2058;878;13827;100;816639
117352;2059;505;13532;1;817144
117353;2060;884;14416;26;818028
117383;2061;636;15052;96;818664
117493;2062;924;15176;69;819588
117572;2063;889;15265;57;820477
117634;2064;978;16243;47;821455
117697;2065;516;15959;3;821971
117700;2066;357;16316;95;822328
117805;2067;660;16176;35;822988
117853;2068;518;16694;79;823506
117948;2069;496;16390;14;824002
117964;2070;860;16450;49;824862
118025;2071;487;16937;49;825349
118075;2072;731;16868;1;826080
118076;2073;696;17564;9;826776
118087;2074;540;18104;9;827316
118103;2075;370;18474;88;827686
118197;2076;756;18430;23;828442
118228;2077;317;18747;96;828759
118336;2078;329;18276;100;829088
118446;2079;843;18319;69;829931
118523;2080;801;18320;40;830732
118571;2081;508;18828;80;831240
118665;2082;757;18785;42;831997
118711;2083;302;19087;58;832299
118772;2084;617;18904;82;832916
118866;2085;482;18586;43;833398
118913;2086;605;19191;57;834003
118975;2087;788;19179;29;834791
119006;2088;496;19675;98;835287
119115;2089;527;19402;73;835814
119190;2090;553;19155;24;836367
119222;2091;925;20080;13;837292
119238;2092;428;20508;19;837720
119270;2093;713;21221;52;838433
119333;2094;350;20771;93;838783
119441;2095;309;20280;11;839092
119457;2096;666;20946;58;839758
119520;2097;821;20967;22;840579
119551;2098;386;21353;71;840965
119627;2099;605;21158;24;841570
119658;2100;613;21771;42;842183
119704;2101;800;22571;3;842983
119707;2102;851;22622;53;843834
119765;2103;333;22955;45;844167
119811;2104;569;23524;32;844736
119858;2105;522;23246;52;845258
119922;2106;356;23602;37;845614
119969;2107;646;23448;19;846260
120001;2108;491;23939;78;846751
120080;2109;568;23707;87;847319
120174;2110;424;23331;96;847743
120283;2111;763;23294;14;848506
120298;2112;460;23754;13;848966
120314;2113;765;24519;10;849731
120329;2114;320;24839;12;850051
120345;2115;362;25201;55;850413
120407;2116;782;25183;81;851195
120500;2117;963;25346;89;852158
120594;2118;732;25278;81;852890
120689;2119;398;25676;55;853288
120750;2120;916;25792;35;854204
120796;2121;367;26159;45;854571
120842;2122;605;25964;47;855176
120905;2123;498;26462;32;855674
120951;2124;841;26503;21;856515
120981;2125;926;27429;29;857441
121013;2126;780;28209;63;858221
121076;2127;346;27755;94;858567
121184;2128;497;27452;26;859064
121215;2129;632;28084;65;859696
121293;2130;502;27786;21;860198
121325;2131;367;28153;71;860565
121403;2132;709;28062;26;861274
121433;2133;790;28852;73;862064
121510;2134;661;28713;50;862725
121572;2135;361;28274;70;863086
121649;2136;697;28971;58;863783
121711;2137;950;29121;83;864733
121805;2138;329;28650;86;865062
121897;2139;620;28470;77;865682
121974;2140;439;28909;94;866121
122069;2141;335;28444;29;866456
122100;2142;445;28889;86;866901
122193;2143;775;28864;22;867676
122225;2144;479;28543;94;868155
122320;2145;314;28857;17;868469
122351;2146;475;28532;24;868944
122383;2147;969;29501;46;869913
122432;2148;655;29356;87;870568
122535;2149;837;30193;78;871405
122627;2150;439;29832;1;871844
122628;2151;400;30232;54;872244
122689;2152;786;30218;94;873030
122798;2153;707;30125;58;873737
122859;2154;491;30616;36;874228
122905;2155;941;30757;83;875169
122996;2156;922;30879;77;876091
123074;2157;359;31238;35;876450
123120;2158;994;31432;44;877444
123168;2159;342;31774;95;877786
123277;2160;687;31661;8;878473
123293;2161;464;32125;96;878937
123403;2162;711;32036;18;879648
123434;2163;737;31973;52;880385
123496;2164;699;32672;98;881084
123603;2165;671;32543;70;881755
123681;2166;692;32435;48;882447
123730;2167;990;32625;87;883437
123820;2168;349;32974;45;883786
123867;2169;702;32876;33;884488
123913;2170;987;33863;56;885475
123974;2171;662;33725;51;886137
124037;2172;813;34538;81;886950
124129;2173;891;34629;47;887841
124191;2174;578;34407;17;888419
124222;2175;478;34885;98;888897
124330;2176;926;35011;4;889823
124346;2177;809;35820;67;890632
124425;2178;484;35504;76;891116
124503;2179;801;35505;61;891917
124564;2180;796;36301;4;892713
124579;2181;770;37071;92;893483
124672;2182;367;36638;38;893850
124719;2183;414;36252;80;894264
124813;2184;991;37243;92;895255
124905;2185;393;36836;31;895648
124951;2186;803;36839;25;896451
124983;2187;477;37316;1;896928
124984;2188;933;38249;62;897861
125060;2189;666;38115;51;898527
125122;2190;455;38570;45;898982
125169;2191;971;38741;15;899953
125184;2192;600;39341;36;900553
125231;2193;829;40170;31;901382
125277;2194;466;39836;61;901848
125339;2195;370;40206;65;902218
125417;2196;976;40382;48;903194
125466;2197;776;40358;41;903970
125511;2198;381;40739;59;904351
125572;2199;783;41522;18;905134
125604;2200;962;41684;44;906096
125650;2201;468;42152;93;906564
125744;2202;422;41774;62;906986
125807;2203;514;41488;36;907500
125854;2204;386;41874;55;907886
125917;2205;342;41416;8;908228
125933;2206;879;42295;49;909107
125996;2207;788;43083;25;909895
126027;2208;890;43173;42;910785
126073;2209;343;43516;89;911128
126167;2210;641;43357;83;911769
126260;2211;609;43166;31;912378
126306;2212;403;43569;97;912781
126415;2213;416;43185;98;913197
126524;2214;724;43109;81;913921
126617;2215;582;42891;18;914503
126648;2216;618;43509;99;915121
126757;2217;380;43089;95;915501
126866;2218;827;43116;13;916328
126881;2219;556;43672;40;916884
126928;2220;587;43459;31;917471
126974;2221;490;43949;32;917961
127020;2222;488;43637;75;918449
127097;2223;549;44186;22;918998
127129;2224;645;44031;67;919643
127209;2225;871;44902;34;920514
127256;2226;677;44779;96;921191
127364;2227;527;44506;45;921718
127411;2228;686;45192;91;922404
127503;2229;329;44721;29;922733
127535;2230;709;45430;12;923442
127550;2231;403;45033;36;923845
127598;2232;780;45813;6;924625
127613;2233;689;46502;72;925314
127691;2234;572;46274;61;925886
127753;2235;700;46974;59;926586
127815;2236;679;46853;81;927265
127907;2237;420;46473;69;927685
127987;2238;994;46667;46;928679
128036;2239;360;47027;74;929039
128112;2240;906;47133;68;929945
128189;2241;318;47451;87;930263
128283;2242;607;47258;24;930870
128314;2243;467;46925;45;931337
128360;2244;794;47719;69;932131
128437;2245;641;47560;61;932772
128499;2246;406;47966;19;933178
128529;2247;854;48020;29;934032
128560;2248;450;48470;92;934482
128653;2249;544;48214;38;935026
128700;2250;920;49134;69;935946
128776;2251;751;49085;25;936697
128808;2252;546;49631;70;937243
128885;2253;430;49261;10;937673
128900;2254;539;49800;60;938212
128963;2255;353;49353;15;938565
128978;2256;717;50070;64;939282
129056;2257;897;50967;82;940179
129150;2258;514;50681;68;940693
129228;2259;440;50321;26;941133
129259;2260;968;51289;46;942101
129306;2261;986;51475;59;943087
129369;2262;614;52089;56;943701
129431;2263;409;51698;54;944110
129494;2264;768;52466;60;944878
129555;2265;564;52230;12;945442
129571;2266;393;52623;97;945835
129681;2267;318;52141;57;946153
129743;2268;366;51707;42;946519
129791;2269;450;52157;68;946969
129869;2270;953;52310;94;947922
129975;2271;315;51825;92;948237
130071;2272;742;51767;46;948979
130118;2273;915;52682;60;949894
130181;2274;792;52674;29;950686
130211;2275;509;53183;40;951195
130257;2276;833;54016;21;952028
130288;2277;933;54149;14;952961
130304;2278;329;54478;47;953290
130351;2279;545;55023;80;953835
130443;2280;968;55191;1;954803
130445;2281;402;55593;81;955205
130537;2282;838;55631;18;956043
130568;2283;620;56251;21;956663
130599;2284;421;55872;47;957084
130646;2285;849;56721;17;957933
130677;2286;498;57219;63;958431
130754;2287;751;57170;54;959182
130817;2288;743;57113;18;959925
130848;2289;967;58080;75;960892
130926;2290;1000;58280;75;961892
131003;2291;428;58708;93;962320
131111;2292;721;58629;98;963041
131220;2293;489;58318;38;963530
131267;2294;310;57828;95;963840
131374;2295;500;57528;45;964340
131420;2296;475;58003;41;964815
131466;2297;482;57685;34;965297
131513;2298;659;58344;97;965956
131624;2299;949;58493;86;966905
131715;2300;745;58438;3;967650
131731;2301;325;58763;96;967975
131840;2302;877;58840;48;968852
131889;2303;434;58474;42;969286
131932;2304;422;58896;74;969708
132011;2305;488;58584;19;970196
132043;2306;370;58954;39;970566
132090;2307;580;59534;60;971146
132153;2308;952;59686;11;972098
132169;2309;959;60645;79;973057
132248;2310;867;60712;44;973924
132296;2311;706;61418;58;974630
132360;2312;816;61434;29;975446
132392;2313;775;62209;69;976221
132471;2314;806;62215;55;977027
132534;2315;429;62644;86;977456
132626;2316;554;62398;9;978010
132642;2317;750;63148;87;978760
132737;2318;627;62975;68;979387
132817;2319;657;62832;9;980044
132832;2320;455;63287;55;980499
132895;2321;388;62875;68;980887
132974;2322;492;63367;66;981379
133053;2323;726;63293;78;982105
133131;2324;520;63013;63;982625
133208;2325;961;63974;38;983586
133256;2326;866;64040;42;984452
133304;2327;375;64415;42;984827
133349;2328;702;64317;35;985529
133396;2329;510;64827;18;986039
133427;2330;465;65292;18;986504
133459;2331;653;65145;27;987157
133491;2332;647;65792;87;987804
133584;2333;665;65657;73;988469
133660;2334;683;65540;17;989152
133693;2335;803;66343;62;989955
133755;2336;348;66691;55;990303
133818;2337;410;66301;26;990713
133848;2338;694;66995;13;991407
133864;2339;365;67360;3;991772
133879;2340;433;66993;15;992205
133894;2341;535;67528;82;992740
133988;2342;782;67510;4;993522
134003;2343;756;68266;65;994278
134079;2344;350;68616;90;994628
134172;2345;559;68375;76;995187
134249;2346;905;68480;48;996092
134299;2347;608;68288;29;996700
134344;2348;689;68977;79;997389
134438;2349;718;68895;33;998107
134486;2350;885;69780;50;998992
134549;2351;397;69377;33;999389
134596;2352;569;69946;89;999958
134689;2353;461;69607;61;1000419
134751;2354;0;68807;88;1000419
134842;2355;0;68807;42;1000419
134889;2356;0;68007;78;1000419
134968;2357;0;67207;32;1000419
135015;2358;0;67207;31;1000419
135062;2359;0;67207;51;1000419
135125;2360;0;66407;53;1000419
135187;2361;0;65607;26;1000419
135217;2362;0;65607;24;1000419
135248;2363;0;65607;66;1000419
135325;2364;0;64807;13;1000419
135341;2365;0;64807;47;1000419
135388;2366;0;64807;26;1000419
135420;2367;0;64007;15;1000419
135435;2368;0;64007;20;1000419
135465;2369;0;64007;37;1000419
135512;2370;0;63207;98;1000419
135622;2371;0;62407;19;1000419
135653;2372;0;62407;18;1000419
135684;2373;0;62407;19;1000419
135715;2374;0;62407;17;1000419
135747;2375;0;61607;51;1000419
135808;2376;0;61607;2;1000419
135810;2377;0;61607;36;1000419
135856;2378;0;60807;61;1000419
135920;2379;0;60807;33;1000419
135966;2380;0;60007;72;1000419
136044;2381;0;60007;44;1000419
136091;2382;0;59207;79;1000419
136171;2383;0;58407;37;1000419
136218;2384;0;58407;29;1000419
136250;2385;0;58407;88;1000419
136344;2386;0;57607;63;1000419
136421;2387;0;56807;94;1000419
136531;2388;0;56007;34;1000419
136577;2389;0;56007;14;1000419
136592;2390;0;55207;37;1000419
136639;2391;0;55207;90;1000419
136735;2392;0;54407;39;1000419
136783;2393;0;54407;4;1000419
136799;2394;0;54407;1;1000419
136801;2395;0;53607;72;1000419
136876;2396;0;53607;51;1000419
136938;2397;0;52807;39;1000419
136984;2398;0;52807;62;1000419
137047;2399;0;52007;88;1000419
137141;2400;0;51207;27;1000419
137173;2401;0;51207;85;1000419
137269;2402;0;50407;33;1000419
137315;2403;0;50407;60;1000419
137378;2404;0;49607;82;1000419
137460;2405;0;48807;89;1000419
137563;2406;0;48807;93;1000419
137657;2407;0;48007;77;1000419
137735;2408;0;47207;2;1000419
137736;2409;0;47207;34;1000419
137781;2410;0;47207;53;1000419
137843;2411;0;46407;98;1000419
137953;2412;0;45607;71;1000419
138030;2413;0;44807;62;1000419
138092;2414;0;44807;84;1000419
138185;2415;0;44007;23;1000419
138216;2416;0;44007;74;1000419
138295;2417;0;43207;76;1000419
138374;2418;0;42407;71;1000419
138451;2419;0;41607;91;1000419
138545;2420;0;41607;16;1000419
138577;2421;0;40807;94;1000419
138687;2422;0;40007;51;1000419
138748;2423;0;40007;40;1000419
138796;2424;0;39207;83;1000419
138888;2425;0;38407;33;1000419
138935;2426;0;38407;51;1000419
138996;2427;0;37607;55;1000419
139058;2428;0;37607;87;1000419
139151;2429;0;36807;96;1000419
139261;2430;0;36007;24;1000419
139292;2431;0;36007;52;1000419
139354;2432;0;35207;18;1000419
139384;2433;0;35207;37;1000419
139431;2434;0;34407;40;1000419
139477;2435;0;34407;28;1000419
139507;2436;0;34407;64;1000419
139587;2437;0;33607;16;1000419
139617;2438;0;33607;47;1000419
139679;2439;0;32807;12;1000419
139694;2440;0;32807;75;1000419
139772;2441;0;32007;60;1000419
139833;2442;0;32007;15;1000419
139848;2443;0;32007;78;1000419
139941;2444;0;31207;18;1000419
139960;2445;0;30407;59;1000419
140034;2446;0;30407;69;1000419
140111;2447;0;29607;72;1000419
140190;2448;0;28807;56;1000419
140250;2449;0;28807;33;1000419
140284;2450;0;28007;91;1000419
140376;2451;0;28007;35;1000419
140424;2452;0;27207;58;1000419
140488;2453;0;27207;26;1000419
140519;2454;0;26407;99;1000419
140627;2455;0;25607;51;1000419
140689;2456;0;25607;42;1000419
140735;2457;0;24807;23;1000419
140766;2458;0;24807;7;1000419
140781;2459;0;24807;27;1000419
140813;2460;0;24807;45;1000419
140858;2461;0;24007;39;1000419
140906;2462;0;24007;46;1000419
140954;2463;0;23207;27;1000419
140985;2464;0;23207;47;1000419
141033;2465;0;23207;49;1000419
141096;2466;0;22407;83;1000419
141187;2467;0;21607;92;1000419
141280;2468;0;20807;85;1000419
141374;2469;0;20807;98;1000419
141482;2470;0;20007;75;1000419
141560;2471;0;19207;88;1000419
141654;2472;0;18407;61;1000419
141718;2473;0;17607;44;1000419
141766;2474;0;17607;40;1000419
141813;2475;0;17607;22;1000419
141842;2476;0;16807;9;1000419
141857;2477;0;16807;66;1000419
141924;2478;0;16007;59;1000419
141998;2479;0;16007;95;1000419
142108;2480;0;15207;13;1000419
142123;2481;0;15207;86;1000419
142215;2482;0;14407;98;1000419
142323;2483;0;13607;97;1000419
142432;2484;0;12807;55;1000419
142494;2485;0;12007;57;1000419
142557;2486;0;12007;52;1000419
142619;2487;0;11207;80;1000419
142713;2488;0;10407;97;1000419
142821;2489;0;9607;60;1000419
142884;2490;0;9607;69;1000419
142962;2491;0;8807;29;1000419
142993;2492;0;8807;65;1000419
143071;2493;0;8007;44;1000419
143117;2494;0;8007;46;1000419
143164;2495;0;7207;55;1000419
143227;2496;0;7207;36;1000419
143274;2497;0;6407;77;1000419
143352;2498;0;5607;73;1000419
143430;2499;0;5607;44;1000419
143477;2500;0;4807;71;1000419
143555;2501;0;4807;24;1000419
143586;2502;0;4007;65;1000419
143665;2503;0;4007;68;1000419
143743;2504;0;3207;46;1000419
143804;2505;0;2407;23;1000419
143834;2506;0;2407;93;1000419
143928;2507;0;1607;95;1000419
144036;2508;0;807;50;1000419
144097;2509;0;807;3;1000419
144100;2510;0;7;79;1000419
144191;2511;0;7;37;1000419
144238;2512;0;0;18;1000419
144270;2513;0;0;99;1000419
144379;2514;0;0;75;1000419
144457;2515;0;0;82;1000419
144549;2516;0;0;36;1000419
144596;2517;0;0;76;1000419
144673;2518;0;0;79;1000419
144754;2519;0;0;55;1000419
144815;2520;0;0;45;1000419
144862;2521;0;0;18;1000419
144893;2522;0;0;20;1000419
144924;2523;0;0;90;1000419
145018;2524;0;0;8;1000419
145034;2525;0;0;3;1000419
145050;2526;0;0;52;1000419
145112;2527;0;0;62;1000419
145189;2528;0;0;64;1000419
145266;2529;0;0;91;1000419
145359;2530;0;0;17;1000419
145391;2531;0;0;39;1000419
145439;2532;0;0;4;1000419
145454;2533;0;0;10;1000419
145469;2534;0;0;14;1000419
145484;2535;0;0;73;1000419
145560;2536;0;0;50;1000419
145623;2537;0;0;47;1000419
145684;2538;0;0;62;1000419
145747;2539;0;0;66;1000419
145825;2540;0;0;79;1000419
145904;2541;0;0;41;1000419
145951;2542;0;0;68;1000419
146027;2543;0;0;20;1000419
146058;2544;0;0;43;1000419
146106;2545;0;0;20;1000419
146136;2546;0;0;58;1000419
146199;2547;0;0;31;1000419
146231;2548;0;0;6;1000419
146245;2549;0;0;14;1000419
146260;2550;0;0;75;1000419
146338;2551;0;0;69;1000419
146417;2552;0;0;76;1000419
146493;2553;0;0;97;1000419
146603;2554;0;0;6;1000419
146618;2555;0;0;30;1000419
146648;2556;0;0;42;1000419
146694;2557;0;0;4;1000419
146710;2558;0;0;34;1000419
146757;2559;0;0;31;1000419
146803;2560;0;0;60;1000419
146864;2561;0;0;67;1000419
146942;2562;0;0;23;1000419
146972;2563;0;0;76;1000419
147051;2564;0;0;77;1000419
147128;2565;0;0;54;1000419
147190;2566;0;0;73;1000419
147268;2567;0;0;21;1000419
147299;2568;0;0;99;1000419
147408;2569;0;0;80;1000419
147501;2570;0;0;2;1000419
147517;2571;0;0;68;1000419
147595;2572;0;0;57;1000419
147657;2573;0;0;85;1000419
147751;2574;0;0;34;1000419
147798;2575;0;0;64;1000419
147876;2576;0;0;31;1000419
147907;2577;0;0;95;1000419
148015;2578;0;0;93;1000419
148109;2579;0;0;18;1000419
148127;2580;0;0;73;1000419
148200;2581;0;0;71;1000419
148277;2582;0;0;66;1000419
148343;2583;0;0;61;1000419
148418;2584;0;0;16;1000419
148449;2585;0;0;39;1000419
148495;2586;0;0;86;1000419
148590;2587;0;0;22;1000419
148621;2588;0;0;77;1000419
148700;2589;0;0;13;1000419
148715;2590;0;0;20;1000419
148746;2591;0;0;46;1000419
148807;2592;0;0;60;1000419
148868;2593;0;0;27;1000419
148898;2594;0;0;44;1000419
148944;2595;0;0;60;1000419
149006;2596;0;0;66;1000419
149085;2597;0;0;18;1000419
149102;2598;0;0;84;1000419
149195;2599;0;0;12;1000419
149210;2600;0;0;77;1000419
149289;2601;0;0;20;1000419
149320;2602;0;0;38;1000419
149367;2603;0;0;52;1000419
149430;2604;0;0;27;1000419
149461;2605;0;0;18;1000419
149492;2606;0;0;95;1000419
149601;2607;0;0;2;1000419
149617;2608;0;0;26;1000419
149649;2609;0;0;64;1000419
149726;2610;0;0;35;1000419
149773;2611;0;0;45;1000419
149819;2612;0;0;76;1000419
149896;2613;0;0;64;1000419
149974;2614;0;0;35;1000419
150020;2615;0;0;72;1000419
150098;2616;0;0;88;1000419
